#################
#...............#
#............../#
#.....###########
#.....###########
#.....###########
#.....###########
#.....###########
#.....###########
#.........#######
###.........#####
#####.........###
#######........##
###########.....#
###########.....#
###########.....#
###########.....#
###########.....#
###########.....#
#...............#
#...............#
#..........######
#...............#
######..........#
######..........#
######..........#
#.............###
#...........#####
#.........#######
#################