NOMOVE
#################
......#....&.....
......#....#.....
......#....#.....
......#....#.....
......#....#.....
......#....#.....
......#....#.....
......#....#.....
......#....#.....
......#....#.....
......#....#.....
......#....#.....
......#....#.....
......#....#.....
......#....#.....
......#....#.....
......#....#.....
......#....#.....
......#....#.....
......#....#.....
......#....#.....
......#....#.....
......#....#.....
......#....#.....
......#....#.....
......#....#.....
......#....#.....
......#....#.....
......#....#.....
......#....#.....
......#....#.....
......#....#.....
......#....#.....
......#....#.....
......#....#.....
......#....#.....
......#....#.....
......#....#.....
......#....#.....
......#....#.....
......#....#.....
...........#.....