MOVE
#################
.................
.................
.................
..............&##
...........######
.........########
........#########
......###########
......###########
......###########
......###########
......###########
......###########
......###########
......###########
........#########
###.....#########
###.....#########
###.....#########
###..............
#####............
.........########
........#########
......########...
....#######......
.................
############.....
############.....
############.....
############.....
############.....
############.....
########......###
............#####
..........#######
........#########