MOVE
#################
......#....&.....
......#....#.....
...........#.....
......#....#.....
.................
......#....#.....
......#..........
...........#.....
......#....#.....
.................
......#....#.....
......#..........
...........#.....
......#....#.....
...........#.....
......#....#.....
......#....#.....
.................
......#....#.....
...........#.....
...........#.....
......#..........
.................
......#....#.....
......#....#.....
...........#.....
...........#.....
......#..........
......#..........
......#....#.....
......#....#.....
...........#.....
...........#.....
......#....#.....
......#....#.....
......#....#.....
......#....#.....
......#....#.....
......#....#.....
#######....######
......#....#.....
...........#.....