#################
#####.........###
.....####......&.
..............###
...........######
........###......
......####.......
##...............
#####.........###
.....###....#####
..........#######
........#########
#####.........###
.....####........
..............###
...........######
........###......
......####.......
##...............
#####.........###
.....###....#####
..........#######
........#########
#####.........###
.....####........
..............###
...........######
........###......
......####.......
##...............
#####.........###
.....###....#####
..........#######
........#########
#####.........###
.....####........
..............###
...........######
........###......
......####.......
##...............
#####.........###
.....###....#####
..........#######
........#########