NOMOVE
#################
........&........
....#########....
......#####......
....#########....
....#########....
....###...###....
.................
#######...#######
#####.......#####
#####...#...#####
#####.......#####
...........######
......###########
##......#########
###.........#####
#####.........###
#######........##
#########........
###########......
#############....
########.........
########......###
............#####
..........#######
........#########
####.............
#####............
#######..........
########........
###########......
#############....
########.........
########......###
............#####
..........#######
...... .#########