NOMOVE
#################
......#....#.....
......#....#.....
......#....#.....
......#....#.....
......#....#.....
......#....#.....
......#....#.....
......#....#.....
......#....#.....
......#....&.....
......#....#.....
......#....#.....
......#....#.....
......#....#.....
......#....#.....
......#....#.....
......#....#.....
......#....#.....
......#....#.....
......#....#.....
......#....#.....
......#....#.....
......#....#.....
......#....#.....
......#....#.....
......#....#.....
......#....#.....
......#....#.....
......#....#.....
......#....#.....
......#....#.....
......#....#.....
......#....#.....
......#....#.....
......#....#.....
......#....#.....
......#....#.....
......#....#.....
......#....#.....
......#....#.....
......#....#.....
...........#.....