NOMOVE
#################
.................
.................
.................
..............&##
......###########
......###########
......###########
......###########
......###########
......###########
..........#######
###.........#####
#####.........###
#######........##
#########........
###########......
###########......
###########......
###########......
###########......
.................
.................
.................
.................
####.............
########.........
########.........
########......###
............#####
..........#######
........#########