MOVE
#################
......#..........
......#....#.....
......#....#.....
......#....#.....
......#....#.....
......#....#.....
......#....#.....
......#....#.....
......#....#.....
..&...#....#.....
......#....#.....
......#....#.....
......#....#.....
......#....#.....
......#....#.....
......#....#.....
......#....#.....
......#....#.....
......#....#.....
......#....#.....
......#....#.....
......#....#.....
......#....#.....
......#....#.....
......#....#.....
......#....#.....
......#....#.....
......#....#.....
......#....#.....
......#....#.....
......#....#.....
......#....#.....
......#....#.....
......#....#.....
......#....#.....
......#....#.....
......#....#.....
......#....#.....
......#....#.....
......#....#.....
......#....#.....
...........#.....