NOMOVE
#################
.................
.................
.................
.................
.................
.................
..............&##
.....############
.....############
.....############
.....############
.....############
.....############
..........#######
###.........#####
#####.........###
#######........##
#########........
############.....
#############....
#############....
###########......
###########......
###########......
#############....
...........##....
####.............
########.........
########.........
########......###
............#####
..........#######
........#########