#################
......#....#.....
......#....#.....
......#....#.....
......#....#.....
......#....#.....
......#....#.....
......#....#.....
......#....#.....
......#....#.....
......#....#.....
......#....#.....
......#....#.....
......#....#.....
......#....#.....
......#....#.....
......#....#.....
......#....#.....
......#....#.....
......#....#.....
......#....#.....
......#....#.....
......#....#.....
......#....#.....
......#....#.....
......#....#.....
......#....#.....
......#....#.....
......#....#.....
......#....#.....
......#....#.....
......#....#.....
......#....#.....
......#....#.....
......#....#.....
......#....#.....
......#....#.....
......#....#.....
......#....#.....
......#....#.....
......#....#.....
......#....#.....
...........#.....