#################
.................
...............o#
......###########
......###########
......###########
......###########
......###########
......###########
..........#######
###.........#####
#####.........###
#######........##
#########........
###########......
###########......
###########......
###########......
###########......
.................
.................
...........######
.................
######...........
######...........
######...........
..............###
............#####
..........#######
..#.....#########