11111111111111111
44444444444444444
44444444444444401
44444411111111111
44444411111111111
44444411111111111
44444411111111111
44444411111111111
44444411111111111
44444444441111111
11144444444411111
11111444444444111
11111114444444411
11111111144444444
11111111111444444
11111111111444444
11111111111444444
11111111111444444
11111111111444444
44444444444444444
44444444444444444
44444444444111111
44444444444444444
11111144444444444
11111144444444444
11111144444444444
44444444444444111
44444444444411111
44444444441111111
44144444111111111
