11111111111111111
88888888888888888
88888888888888801
88888811111111111
88888811111111111
88888811111111111
88888811111111111
88888811111111111
88888811111111111
88888888881111111
11188888888811111
11111888888888111
11111118888888811
11111111188888888
11111111111888888
11111111111888888
11111111111888888
11111111111888888
11111111111888888
88888888888888888
88888888888888888
88888888888111111
88888888811118888
11118888888888888
11111188888888888
11111111888888888
11111111118888111
88888888888811111
88888888881111111
88188888111111111
